21 21
S ###################
  # #   #           #
# # # ##### #########
#   # #   #     # # #
# ### ### ### # # # #
#   # #       #     #
### # # # ### # # # #
# # #   #   # # # # #
# # # ###############
#       #     # # # #
### ### ##### # # # #
#   #     #   #   # #
# ####### ### ### # #
#   #   #       #   #
# ##### # # ### # ###
#   # # # #   #     #
### # # ### ### # ###
#   # #   # # # #   #
# ### ### # # # # # #
#         # #   # # #
###################E#
