11 41
#########################################
S     #     #     # #         #         #
# ##### ### # # ### ####### # ### ##### #
#       # #   #     #     # #     #     #
# ####### ########### ### # ####### #####
#       #       #     # #   # #   #   # #
####### # ### # # # ### ##### # # ### # #
#       # #   # # # #   #   #   #   #   #
# ######### ### ### # ### # # ##### ### #
#           #       #     #       #     E
#########################################
